Trapinch & Vibrava - Ground/Bug
Flabebe, Floette, & Florges - Fairy/Grass
Banette - Ghost/Dark
Luxray - Electric/Dark
Gogoat - Grass/Ground
Lilligant - Grass/Fire
Politoed - Water/Sound
Granbull - Fairy/Fighting
Druddigon - Dragon/Fighting
Electivire - Electric/Fighting
Magmortar - Fire/Poison
Gligar & Gliscor - Ground/Poison
Braviary - Fighting/Flying
Gyarados - Water/Dragon
Porygon & Porygon2 - Normal/Pyschic
Porygon-Z - Electric/Pyschic
Misdreavus & Mismagius - Ghost/Psychic
Absol - Dark/Fairy
Lopunny - Normal/Fighting
Glalie - Ice/Steel
Blastoise - Water/Steel
Charizard - Fire/Dragon
Beautifly - Bug/Fairy
Yanmega - Bug/Dragon
Voltorb & Electrode - Electric/Sound
Girafarig - Dark/Psychic
Dragonite - Dragon/Fairy
Ponyta & Rapidash - Fire/Fairy
Glameow & Purugly - Normal/Dark
Igglybuff, Jigglypuff, Wigglytuff - Sound/Fairy
Noibat & Noivern - Sound/Dragon
Mime Jr. & Mr. Mime - Psychic/Sound
Snorlax - Normal/Sound
Zubat, Golbat, & Crobat - Poison/Sound