Important Item Locations

Oran Berry - Zigzagoon
Sitrus Berry - Zigzagoon
Pecha Berry - Poochyena
Rawst Berry - Numel
Lum Berry - Slakoth
Leppa Berry - Linoone
Babiri Berry - Venonat
Charti Berry - Taillow
Chilan Berry - Rattata
Chople Berry - Poochyena
Coba Berry - Wurmple
Colbur Berry - Ralts
Haban Berry - Ekans
Kasib Berry - Spearow
Kebia Berry - Hoppip
Occa Berry - Caterpie
Passho Berry - Wingull
Payapa Berry - Weedle
Rindo Berry - Carvanha
Shuca Berry - Pidgey
Tanga Berry - Bellsprout
Wacan Berry - Hoothoot
Yache Berry - Ledyba

Exp. Share - Porygon
Eviolite - Koffing/Munchlax
Lucky Egg - Wingull
Black Sludge - Grimer
Leftovers - Munchlax
Rare Candy - Mudkip/Treecko/Torchic
Mystic Water - Mudkip
Miracle Seed - Treecko
Charcoal - Torchic
Life Orb - Baltoy
PP Max - Steelix
Light Clay - Stantler
Choice Specs - Omanyte
Choice Band - Kabuto
Choice Scarf - Anorith